code	label_sv	label_en	comment
a-af---	Afghanistan	Afghanistan	
f------	Afrika	Africa	Kontinent
e-aa---	Albanien	Albania	
f-ae---	Algeriet	Algeria	
e-an---	Andorra	Andorra	
f-ao---	Angola	Angola	
nwaq---	Antigua och Barbuda	Antigua and Barbuda	
s-ag---	Argentina	Argentina	
a-ai---	Armenien	Armenia (Republic)	
a------	Asien	Asien	Kontinent
u------	Australasien	Australasia	Kontinent
u-at---	Australien	Australia	
a-aj---	Azerbajdzjan	Azerbaijan	
nwbf---	Bahamas	Bahamas	
a-ba---	Bahrain	Bahrain	
a-bg---	Bangladesh	Bangladesh	
nwbb---	Barbados	Barbados	
e-be---	Belgien	Belgium	
ncbh---	Belize	Belize	
f-dm---	Benin	Benin	
a-bt---	Bhutan	Bhutan	
s-bo---	Bolivia	Bolivia	
e-bn---	Bosnien och Herzegovina	Bosnia and Hercegovina	
f-bs---	Botswana	Botswana	
s-bl---	Brasilien	Brazil	
a-bx---	Brunei	Brunei	
e-bu---	Bulgarien	Bulgaria	
f-uv---	Burkina Faso	Burkina Faso	
a-br---	Burma	Burma	
f-bd---	Burundi	Burundi	
lncv---	Cap Verde	Cape Verde	
f-cx---	Centralafrikanska republiken	Central African Republic	
s-cl---	Chile	Chile	
s-ck---	Colombia	Colombia	
nccr---	Costa Rica	Costa Rica	
a-cy---	Cypern	Cyprus	
e-dk---	Danmark	Denmark	
f-ft---	Djibouti	Djibouti	
nwdr---	Dominikanska republiken	Dominican Republic	
s-ec---	Ecuador	Ecuador	
f-ua---	Egypten	Egypt	
f-eg---	Ekvatorialgunea	Equatorial Guinea	
nces---	El Salvador	El Salvador	
f-iv---	Elfenbenskusten	Côte d'Ivoire	
f-ea---	Eritrea	Eritrea	
e-er---	Estland	Estonia	
f-sq---	Eswatini	Eswatini
f-et---	Etiopien	Ethiopia	
e------	Europa	Europe	Kontinent
pofj--- Fiji	Fiji	
a-ph---	Filippinerna	Philippines	
e-fi---	Finland	Finland	
e-fr---	Frankrike	France	
s-fg---	Franska Guyana	French Guiana	
pofp---	Franska Polynesien	French Polynesia	
lnfa---	Färöarna	Faroe Islands	
a-ts---	Förenade Arabemiraten	United Arab Emirates	
n-us---	Förenta staterna	United States	
f-go---	Gabon	Gabon	
f-gm---	Gambia	Gambia	
a-gs---	Georgien	Georgia (Republic)	
f-gh---	Ghana	Ghana	
e-gr---	Grekland	Greece	
n-gl---	Grönland	Greenland	
ncgt---	Guatemala	Guatemala	
f-gv---	Guinea	Guinea	
f-pg---	Guinea-Bissau	Guinea-Bissau	
s-gy---	Guyana	Guyana	
nwht---	Haiti	Haiti	
ncho---	Honduras	Honduras	
a-ii---	Indien	India	
i------	Indiska oceanen	Indian Ocean	Kontinent
a-io---	Indonesien	Indonesia	
a-iq---	Irak	Iraq	
a-ir---	Iran	Iran	
e-ie---	Irland	Ireland	
e-ic---	Island	Iceland	
a-is---	Israel	Israel	
e-it---	Italien	Italy	
nwmj---	Jamaica	Jamaica	
a-ja---	Japan	Japan	
a-jo---	Jordanien	Jordan	
a-cb---	Kambodja	Cambodia	
f-cm---	Kamerun	Kameroon	
n-cn---	Kanada	Canada	
a-kz---	Kazakstan	Kazakhstan	
f-ke---	Kenya	Kenya	
a-cc---	Kina	China	
a-kg---	Kirgizistan	Kyrgyzstan	
i-cq---	Komorerna	Comoros	
f-cf---	Kongo (Brazzaville)	Congo (Brazzaville)	
f-cg---	Kongo (Kinshasa)	Congo (Democratic Republic)	
a-kr---	Korea	Korea	
e-kv---	Kosovo	Kosovo	
e-ci---	Kroatien	Croatia	
nwcu---	Kuba	Cuba	
a-ku---	Kuwait	Kuwait	
a-ls---	Laos	Laos	
f-lo---	Lesotho	Lesotho	
e-lv---	Lettland	Latvia	
a-le---	Libanon	Lebanon	
f-lb---	Liberia	Liberia	
f-ly---	Libyen	Libya	
e-lh---	Liechtenstein	Liechtenstein	
e-li---	Litauen	Lithuania	
e-lu---	Luxemburg	Luxembourg	
a-mh---	Macao	Macao	OBSOLET kod
f-mg---	Madagaskar	Madagascar	
f-mw---	Malawi	Malawi	
a-my---	Malaysia	Malaysia	
i-xc---	Maldiverna	Maldives	
f-ml---	Mali	Mali	
e-mm---	Malta	Malta	
f-mr---	Marocko	Morocco	
nwmq---	Martinique	Martinique	
f-mu---	Mauretanien	Mauritania	
i-mf---	Mauritius	Mauritius	
n-mx---	Mexiko	Mexico	
f-mz---	Moçambique	Mozambique	
e-mv---	Moldavien	Moldova	
e-mc---	Monaco	Monaco	
a-mp---	Mongoliet	Mongolia	
e-mo---	Montenegro	Montenegro	
f-sx---	Namibia	Namibia	
e-ne---	Nederländerna	Netherlands	
a-np---	Nepal	Nepal	
ncnq---	Nicaragua	Nicaragua	
f-ng---	Niger	Niger	
f-nr---	Nigeria	Nigeria	
n------	Nordamerika	North America	Kontinent
a-kn---	Nordkorea	Korea (North)	se även a-kr-- (Korea)
e-xn---	Nordmakedonien	North Macedonia	Tidigare: Makedonien
a-vn---	Norra Vietnam	Viet Nam, North	OBSOLET kod, se a-vt--- (Vietnam)
e-no---	Norge	Norway	
a-nw---	Nya Guinea	New Guinea	
ponl---	Nya Kaledonien	New Caledonia	
u-nz---	Nya Zeeland	New Zealand	
xx	Okänd nationalitet / Okänt verksamhetsland	Unknown	Librisdefinierad kod. Används endast i Auktoritetsformatet
a-mk---	Oman	Oman	
a-pk---	Pakistan	Pakistan	
ncpn---	Panama	Panama	
a-pp---	Papua Nya Guinea	Papua New Guinea	
s-py---	Paraguay	Paraguay	
s-pe---	Peru	Peru	
e-pl---	Polen	Poland	
e-po---	Portugal	Portugal	
nwpr---	Puerto Rico	Puerto Rico	
a-qa---	Qatar	Qatar	
i-re---	Réunion	Réunion	
e-rm---	Rumänien	Romania	
f-rw---	Rwanda	Rwanda	
e-ru---	Ryssland	Russia (Federation)	
f-sf---	Sao Tome och Principe	Sao Tome and Principe	
a-su---	Saudiarabien	Saudi Arabia	
e-sz---	Schweiz	Switzerland	
f-sg---	Senegal	Senegal	
e-rb---	Serbien	Serbia	
i-se---	Seychellerna	Seychelles	
f-sl---	Sierra Leone	Sierra Leone	
a-si---	Singapore	Singapore	
e-xo---	Slovakien	Slovakia	
e-xv---	Slovenien	Slovenia	
f-so---	Somalia	Somalia	
e-sp---	Spanien	Spanien	
a-ce---	Sri Lanka	Sri Lanka	
e-uk---	Storbritannien	Great Britain	
f-sj---	Sudan	Sudan	
s-sr---	Surinam	Surinam	
s-sq---	Swaziland	Swaziland	
e-sw---	Sverige	Sweden	
f-sa---	Sydafrika	South Africa	
s------	Sydamerika	South America	Kontinent
a-ko---	Sydkorea	Korea (South)	se även a-kr--- (Korea)
f-sd---	Sydsudan	South Sudan	
a-ys---	Sydjemen	Yemen (People's Democratic Republic)	OBSOLET kod, se a-ye--- (Jemen)
a-sy---	Syrien	Syria	
a-vs---	Södra Vietnam	Viet Nam, South	OBSOLET kod, se a-vt--- (Vietnam) 
a-ta---	Tadzjikistan	Tajikistan	
a-ch---	Taiwan	Taiwan	
f-tz---	Tanzania	Tanzania	
f-cd---	Tchad	Chad	
a-th---	Thailand	Thailand	
e-xr---	Tjeckien	Czech Republic	
e-cs---	Tjeckoslovakien	Czechoslovakia	
f-tg---	Togo	Togo	
nwtr---	Trinidad och Tobago	Trinidad and Tobago	
f-ti---	Tunisien	Tunisia	
a-tu---	Turkiet	Turkey	
a-tk---	Turkmenistan	Turkmenistan	
e-gx---	Tyskland	Germany	
f-ug---	Uganda	Uganda	
e-un---	Ukraina	Ukraine	
e-hu---	Ungern	Hungary	
s-uy---	Uruguay	Uruguay	
a-uz---	Uzbekistan	Uzbekistan	
e-vc---	Vatikanstaten	Vatican City
s-ve---	Venezuela	Venezuela	
a-vt---	Vietnam	Vietnam	
e-bw---	Vitryssland	Belarus	
e-gw---	Västra Tyskland	Germany (West)	se även a-gx--- (Tyskland)
a-ye---	Yemen	Yemen (Republic)	
f-za---	Zambia	Zambia	
f-rh---	Zimbabwe	Zimbabwe	
e-au---	Österrike	Austria	
e-ge---	Östra Tyskland	Germany (East)	se även a-gx--- (Tyskland)
a-em---	Östtimor	Timor-Leste	
